ath	ATH	Arabidopsis thaliana	Viridiplantae;Magnoliophyta;eudicotyledons;Brassicaceae;
cbr	CBR	Caenorhabditis briggsae	Metazoa;Nematoda;
cel	CEL	Caenorhabditis elegans	Metazoa;Nematoda;
dme	DME	Drosophila melanogaster	Metazoa;Arthropoda;
hsa	HSA	Homo sapiens	Metazoa;Vertebrata;Mammalia;Primates;Hominidae;
mmu	MMU	Mus musculus	Metazoa;Vertebrata;Mammalia;Rodentia;
osa	OSA	Oryza sativa	Viridiplantae;Magnoliophyta;monocotyledons;
rno	RNO	Rattus norvegicus	Metazoa;Vertebrata;Mammalia;Rodentia;
ebv	VRL	Epstein Barr virus	Viruses;
gga	GGA	Gallus gallus	Metazoa;Vertebrata;Aves;
dps	DPS	Drosophila pseudoobscura	Metazoa;Arthropoda;
dre	DRE	Danio rerio	Metazoa;Vertebrata;Pisces;
xla	XLA	Xenopus laevis	Metazoa;Vertebrata;Amphibia;
zma	ZMA	Zea mays	Viridiplantae;Magnoliophyta;monocotyledons;
sbi	SBI	Sorghum bicolor	Viridiplantae;Magnoliophyta;monocotyledons;
kshv	VRL	Kaposi sarcoma-associated herpesvirus	Viruses;
oar	OAR	Ovis aries	Metazoa;Vertebrata;Mammalia;Ruminantia;
ame	AME	Apis mellifera	Metazoa;Arthropoda;
aga	AGA	Anopheles gambiae	Metazoa;Arthropoda;
cfa	CFA	Canis familiaris	Metazoa;Vertebrata;Mammalia;Carnivora;
mghv	VRL	Mouse gammaherpesvirus 68	Viruses;
hcmv	VRL	Human cytomegalovirus	Viruses;
mtr	MTR	Medicago truncatula	Viridiplantae;Magnoliophyta;eudicotyledons;Fabaceae;
sof	SOF	Saccharum officinarum	Viridiplantae;Magnoliophyta;monocotyledons;
gma	GMA	Glycine max	Viridiplantae;Magnoliophyta;eudicotyledons;Fabaceae;
ptc	PTC	Populus trichocarpa	Viridiplantae;Magnoliophyta;eudicotyledons;Salicaceae;
ssc	SSC	Sus scrofa	Metazoa;Vertebrata;Mammalia;Suina;
age	AGE	Ateles geoffroyi	Metazoa;Vertebrata;Mammalia;Primates;Atelidae;
ggo	GGO	Gorilla gorilla	Metazoa;Vertebrata;Mammalia;Primates;Hominidae;
lla	LLA	Lagothrix lagotricha	Metazoa;Vertebrata;Mammalia;Primates;Atelidae;
lca	LCA	Lemur catta	Metazoa;Vertebrata;Mammalia;Primates;Lemuridae;
mml	MML	Macaca mulatta	Metazoa;Vertebrata;Mammalia;Primates;Cercopithecidae;
mne	MNE	Macaca nemestrina	Metazoa;Vertebrata;Mammalia;Primates;Cercopithecidae;
ppa	PPA	Pan paniscus	Metazoa;Vertebrata;Mammalia;Primates;Hominidae;
ppy	PPY	Pongo pygmaeus	Metazoa;Vertebrata;Mammalia;Primates;Hominidae;
sla	SLA	Saguinus labiatus	Metazoa;Vertebrata;Mammalia;Primates;Cebidae;
ptr	PTR	Pan troglodytes	Metazoa;Vertebrata;Mammalia;Primates;Hominidae;
fru	FRU	Fugu rubripes	Metazoa;Vertebrata;Pisces;
tni	TNI	Tetraodon nigroviridis	Metazoa;Vertebrata;Pisces;
ppt	PPT	Physcomitrella patens	Viridiplantae;Embryophyta;
sv40	VRL	Simian virus 40	Viruses;
rlcv	VRL	Rhesus lymphocryptovirus	Viruses;
xtr	XTR	Xenopus tropicalis	Metazoa;Vertebrata;Amphibia;
bta	BTA	Bos taurus	Metazoa;Vertebrata;Mammalia;Ruminantia;
hsv1	VRL	Herpes Simplex Virus 1	Viruses;
bmo	BMO	Bombyx mori	Metazoa;Arthropoda;
sme	SME	Schmidtea mediterranea	Metazoa;Platyhelminthes;
mdv1	VRL	Mareks disease virus	Viruses;
mdo	MDO	Monodelphis domestica	Metazoa;Vertebrata;Mammalia;Metatheria;
ghr	GHR	Gossypium hirsutum	Viridiplantae;Magnoliophyta;eudicotyledons;Malvaceae;
gra	GRA	Gossypium rammindii	Viridiplantae;Magnoliophyta;eudicotyledons;Malvaceae;
ghb	GHB	Gossypium herbecium	Viridiplantae;Magnoliophyta;eudicotyledons;Malvaceae;
cre	CRE	Chlamydomonas reinhardtii	Protistae;
rrv	VRL	Rhesus monkey rhadinovirus	Viruses;
cgr	CGR	Cricetulus griseus	Metazoa;Vertebrata;Mammalia;Rodentia;
mdv2	VRL	Mareks disease virus type 2	Viruses;
bna	BNA	Brassica napus	Viridiplantae;Magnoliophyta;eudicotyledons;Brassicaceae;
pta	PTA	Pinus taeda	Viridiplantae;Coniferophyta;
smo	SMO	Selaginella moellendorffii	Viridiplantae;Embryophyta;
hiv1	VRL	Human immunodeficiency virus 1	Viruses;
tae	TAE	Triticum aestivum	Viridiplantae;Magnoliophyta;monocotyledons;
tca	TCA	Tribolium castaneum	Metazoa;Arthropoda;
ddi	DDI	Dictyostelium discoideum	Mycetozoa;
mcmv	VRL	Mouse cytomegalovirus	Viruses;
cpa	CPA	Carica papaya	Viridiplantae;Magnoliophyta;eudicotyledons;Caricaceae;
pbi	PBI	Pygathrix bieti	Metazoa;Vertebrata;Mammalia;Primates;Cercopithecidae;
ssy	SSY	Symphalangus syndactylus	Metazoa;Vertebrata;Mammalia;Primates;Hominidae;
bol	BOL	Brassica oleracea	Viridiplantae;Magnoliophyta;eudicotyledons;Brassicaceae;
bra	BRA	Brassica rapa	Viridiplantae;Magnoliophyta;eudicotyledons;Brassicaceae;
vvi	VVI	Vitis vinifera	Viridiplantae;Magnoliophyta;eudicotyledons;Vitaceae;
oan	OAN	Ornithorhynchus anatinus	Metazoa;Vertebrata;Mammalia;Prototheria;
csa	CSA	Ciona savignyi	Metazoa;Urochordata;
odi	ODI	Oikopleura dioica	Metazoa;Urochordata;
cin	CIN	Ciona intestinalis	Metazoa;Urochordata;
sly	SLY	Solanum lycopersicum	Viridiplantae;Magnoliophyta;eudicotyledons;Solanaceae;
dan	DAN	Drosophila ananassae	Metazoa;Arthropoda;
der	DER	Drosophila erecta	Metazoa;Arthropoda;
dgr	DGR	Drosophila grimshawi	Metazoa;Arthropoda;
dmo	DMO	Drosophila mojavensis	Metazoa;Arthropoda;
dpe	DPE	Drosophila persimilis	Metazoa;Arthropoda;
dse	DSE	Drosophila sechellia	Metazoa;Arthropoda;
dsi	DSI	Drosophila simulans	Metazoa;Arthropoda;
dvi	DVI	Drosophila virilis	Metazoa;Arthropoda;
dwi	DWI	Drosophila willistoni	Metazoa;Arthropoda;
dya	DYA	Drosophila yakuba	Metazoa;Arthropoda;
bkv	VRL	BK polyomavirus	Viruses;
jcv	VRL	JC polyomavirus	Viruses;
